1111111111111111111
10C00P000000C000C01
111111111111111C0C1
1000C00000C00C00001
1C00111111111111111
1000C0000000C000001
111111111111111C0C1
1000C00000C00C00C01
1E11111111111111111
1111111111111111111