1111111111
1P00000001
100CCCCC01
1000000E01
1111111111