111111111111111111111111111111111111111111111111111111111111111
100000000000011111111111111111111110000000000000000000000000011
111111111110011111111111111111111110011111111111111111111111111
111111111110000000000000000000000000011111111111111111111111111
111111111110011111111111111111111111111111111111111111111111111
111111111110E11111111111111111111111111111111111111111111111111
111111111110011111111111111111111111111111111111111111111111111
100000000000011111111111111111111111111111111111111111111111111
111111111110000000000C000000000000C0001111111111111111111111111
1111111111111111111111111111111111100000000000000000C0000000011
111111111111111111111111111111111111111111111111111111111100011
111111111111111111111111111111111111111111111111111111111100P11
111111111111111111111111111111111111111111111111111111111111111