1111111111
1C000000C1
1000000001
10C0C0C0E1
1PCCCCCCC1
100C0C0C01
1000000001
1C000000C1
1111111111