1111111111111
1C00PC00C00E1
1111111111111